500 0
1000    0
1500    0
2000    0
2500    0
3000    0
